################
#      0       #
#  0000 00 0 0 #
#           0  #
#   00000000   #
# 000          #
#  00111100000 #
#  0           #
#  0  110 0 000#
#  0  11       #
#    111       #
#  0 0 00000000#
#        0     #
#    0 0   000 #
# 0     00     #
################